16 16
0000100000001000
0110101111101010
0010000000101011
1011111110100010
0000000100111010
1011110111100000
0000000000111111
0111011110010001
0000000011110100
1101111001010110
0001011100010100
0111000111110101
0100010010110101
0001111010000100
1011001011101110
0000011000000010